________________________
|----------------------|
|--*-|-------|------@--|
|----|-------|---------|
|----|-------|________-|
|----|-----------------|
|----|_________--------|
|----------------------|
|------------2---------|
________________________